RRRRRRRRRRRRRRR
R.............R
R.............R
R.............R
RS............R
R.............R
R.............R
R.............R
Rl............R
RS............R
R.............R
R.............R
R.............R
R.............R
RS............R
RS............R
RL............R
RL............R
R-............R
RLL...........R
RLL...........R
RLL...........R
R-............R
R-............R
RLLL..........R
RLLL..........R
R.............R
R.............R
R.............R
R.............R
RS............R
RS............R
R.............R
R.............R
R.............R
RL............R
RL............R
RL............R
R-............R
R-............R
RL............R
RL............R
RLS...........R
RLS...........R
RL............R
RL............R
RL............R
R-............R
R-............R
R-............R
RLL...........R
RLL...........R
RLLS..........R
RLL...........R
RLL...........R
RLL...........R
R-............R
R.............R
R-............R
R-.L..........R
R.............R
R-............R
R-............R
R-..L.........R
RLS...........R
RLS...........R
R-............R
R-...L........R
RLS...........R
R-............R
R-............R
R-....L.......R
RLS...........R
R-......L.....R
R-......L.....R
R-............R
R-....L.......R
R.....L.......R
RLLLLLL.......R
RLLLLLL.......R
RLLLLLLS......R
RLLLLLLS.L....R
RLLLLLLS.L....R
RLLLLLLS......R
RLLLLLL.......R
RLLLLLL.......R
RLLLLLL.......R
RLLLLLL.......R
RLLLLLS.......R
RLLLLLS.L.....R
RLLLLLS.L.....R
RLLLLLS.......R
RLLL..........R
RLLL..........R
RLLL.sL.......R
RLLL.sL.......R
RLLL.sL.......R
RLLL..........R
RLLL..........R
RLLLLL........R
RLLLLL........R
RLLLLLS.......R
RLLLS.........R
RLLL..........R
RLLL..........R
RLLL..........R
R..L..........R
R..L..........R
R..L..........R
R.............R
R.............R
R.............R
R.............R
R.............R
R.............R
R.............R
R.............R
R.............R
R.............R
R.............R
R.............R
R.............R
R.............R
R.............R
R.............R
R.............R
R.............R
R.............R
R.............R
R.............R
R.............R
R.............R
R.............R
RRRRRRRRRRRRRRR