RRRRRRRRRRRRRRR
R.............R
R.............R
R.............R
R.............R
R.............R
R.............R
RS............R
R.............R
R.............R
R.............R
R.............R
R.............R
R.............R
R.............R
R.............R
R.............R
R.............R
R.............R
RS............R
RS............R
R.............R
R.............R
R.............R
R.............R
R.............R
R.............R
R.............R
R.............R
R.............R
R.............R
R.............R
Rl............R
RLG...........R
RLG...........R
Rl............R
R.............R
R.............R
R.............R
R.............R
R.............R
RL............R
RG............R
R-............R
R+............R
R-............R
RLG...........R
R-............R
R+............R
R.............R
R+.L..........R
R-............R
R+............R
R-............R
R+..G.........R
R-............R
R+............R
R-............R
R-...G........R
R+............R
R-............R
R+............R
R-....L.......R
R+............R
R.............R
R.............R
R......G......R
R.............R
Rl............R
Rl............R
R.......L.....R
R.............R
R....L........R
R.............R
R.L...........R
R.............R
R.............R
R.............R
R.............R
R.............R
R.............R
R.............R
R.............R
R.............R
R.............R
R.............R
RS............R
Rl............R
R.............R
R.............R
R.............R
R.............R
R.............R
Rl............R
RS............R
R.............R
R.............R
R.............R
R.............R
R.............R
R.............R
Rl............R
RS............R
R.............R
R.............R
R.............R
R.............R
R.............R
R.............R
R.............R
R.............R
R.............R
R.............R
R.............R
RL............R
RL............R
RL............R
RG............R
R-............R
R+............R
R-.L..........R
R-.G..........R
R+.G..........R
R-.G..........R
R-.L..........R
R+............R
R.............R
R.............R
REEEEEEEEEEEEER