RRRRRRRRRRRRRRR
R.............R
R.............R
R.............R
R.............R
R.............R
R.............R
RS............R
R.............R
R.............R
R.............R
Rl............R
RS............R
R.............R
R.............R
R.............R
R.............R
RS............R
RS............R
RL............R
RL............R
R-............R
RLL...........R
RLL...........R
RLL...........R
R-............R
R+............R
RLLL..........R
RLLL..........R
R.............R
R.............R
R.............R
R.............R
RS............R
RS............R
R.............R
R.............R
R.............R
RL............R
RL............R
RL............R
R-............R
R+............R
RL............R
RL............R
RLS...........R
RLS...........R
RL............R
RL............R
RL............R
R-............R
R+............R
R-............R
RLL...........R
RLL...........R
RLLS..........R
RLL...........R
RLL...........R
RLL...........R
R-............R
R.............R
R+............R
R-.L..........R
R.............R
R-............R
R+............R
R-..L.........R
RLS...........R
RLS...........R
R-............R
R-...L........R
RLS...........R
R-............R
R+............R
R-....L.......R
RLS...........R
R+......L.....R
R-......L.....R
R+............R
R-....L.......R
R.....L.......R
RLLLLLL.......R
RLLLLLL.......R
RLLLLLS.......R
RLLLLLS.L.....R
RLLLLLS.L.....R
RLLLLLS.......R
RLLLLLL.......R
RLLLLLL.......R
RLLLLLL.......R
RLLLLLL.......R
RLLLLLS.......R
RLLLLLS.L.....R
RLLLLLS.L.....R
RLLLLLS.......R
R.............R
R.............R
RL............R
RL............R
RL............R
RL............R
RLS...........R
R.............R
RLLL..........R
RLLL..........R
RLLL.sL.......R
RLLL.sL.......R
RLLL.sL.......R
RLLL..........R
RLLL..........R
RLLLLL........R
RLLLLL........R
RLLLLL........R
RLLLLL........R
RLLLLL........R
RLLLLLS.......R
RLLLS.........R
RLLL..........R
RLLL..........R
RLLL..........R
R..L..........R
R..L..........R
R..L..........R
R.L...........R
R.L...........R
R.L...........R
R.L...........R
R.LS..........R
RL............R
RL............R
RL............R
RL............R
RLS...........R
R-............R
R-............R
RL............R
R-............R
R+............R
R-............R
RLL...........R
R-............R
R+............R
R.............R
R+.L..........R
R-............R
R+............R
R-............R
R+..L.........R
R-............R
R+............R
R-............R
R-...L........R
R+............R
R-............R
R+............R
R-....L.......R
R+............R
R-............R
R+............R
R+.....L......R
R.............R
R.............R
R.............R
R.......LS....R
R.............R
R.............R
R.............R
R.............R
R.............R
R....sL.......R
RS...sL.......R
RS...sL.......R
R....sL.......R
R.............R
R.............R
R.............R
R.............R
R.............R
R.............R
R....sL.......R
RS...sL.......R
RS...sL.......R
R....sL.......R
R.............R
R.............R
R.............R
R.............R
RL............R
RL............R
RLS...........R
RLLL..........R
RLLL..........R
RLLL..........R
RLLL..........R
R-............R
R+............R
R-............R
RLLL..........R
R-............R
R+............R
R+............R
RLLLL.........R
R-............R
RLL...........R
RLL...........R
RLL...........R
R-............R
R+............R
R-............R
R-L...........R
R.L...........R
R.L.....sL....R
R.LS....sL....R
R.LS....sL....R
R.............R
R.............R
R.............R
R.............R
R.............R
R.............R
R.............R
R.............R
R.............R
R.............R
R.............R
RL............R
RL............R
RLS...........R
RLLL..........R
RLLL..........R
RLLL..........R
RLLL..........R
R-............R
R+............R
R-............R
RLLL..........R
R-............R
R-............R
R+............R
RLLLL.........R
R-............R
RLL...........R
RLL...........R
RLL...L.......R
R-............R
R+............R
R-............R
R-L...LL...sLLR
RLL........sLLR
R.........sLLLR
R.........sLLLR
R.........sLLLR
RL............R
R.............R
R.............R
R.............R
RLL...........R
R-............R
R+............R
R-............R
RLLL..........R
R-............R
R+............R
R-............R
RLLLL.........R
R-............R
R-............R
R+............R
RLLLLL........R
R-............R
R+............R
R-............R
RLLLLLL.......R
R-............R
R+..L.........R
R-............R
R+.L..........R
R-............R
R+L...........R
R-............R
R+............R
R-............R
RLLL..........R
RLLL..........R
RLLL..........R
RLLL..........R
R-............R
R+L...........R
R-............R
R+............R
R-............R
R+LL..........R
R.............R
R.............R
R.............R
R.............R
RS............R
RS............R
RL............R
RL............R
R.............R
R..L..sL......R
R..L..sL......R
R.............R
R.L...........R
R.L...........R
R.............R
R...L.........R
R...L.........R
R.............R
R....L........R
R....L........R
R.......sL....R
R..L....sL....R
R..L..........R
R..L..........R
R..LS.........R
R.............R
R.............R
R.............R
RS...sL.......R
RS...sL.......R
R.............R
R.............R
RS...sL.......R
RS...sL.......R
R.............R
R.............R
RS...sL.......R
RS...sL.......R
R.............R
R.............R
RS...sL.......R
RS...sL.......R
R.............R
R.............R
R.............R
R.............R
R.............R
R.............R
RL............R
R.............R
R.............R
R.............R
RLL...sL......R
RS............R
RS............R
RS............R
RLLL....sL....R
RS............R
R-L...........R
R-............R
R-............R
R-............R
R-.L..........R
RS............R
RS............R
RS..L...L.....R
RS............R
RS............R
RS....L...L...R
R-........L...R
RS........L...R
RS........L...R
R+........L...R
RS........L...R
RS........LS..R
R-............R
RS............R
R.............R
R.............R
R.............R
REEEEEEEEEEEEER